WWWWWWWWWWWWWWW
W   R WR      W
W  W WW  WW WWW
WW  B       BPW
WW  WWW W  WWWW
WT     R WWWVWW
WWWWWWWW      W
W    R  WWWW  W
WV            W
WWWWWWWWWWWWWWW
S
Made By: Mark Delfavero