WWWWWWWWWWWWWWW
W   R         W
W     WWWWWWW W
W  T      B W W
W    WWWWWW W W
W  B      R   W
W  B    WWWWW W
W WWW       W W
WP        B WTW
WWWWWWWWWWWWWWW
S
Made By: Mark Delfavero