WWWWWWWWWWWWWWW
W      R      W
W WWWWWWW     W
WVW   V     B W
W WPW  B   WW W
W WWWWWWWWWWWWW
W             W
W W B    WWWW W
W  VB      WR W
WWWWWWWWWWWWWWW
S
Made By: Mark Delfavero