WWWWWWWWWWWWWWW
W    B    B   W
W    B    B   W
W    B    B   W
W    B    B   W
W    B P  B   W
W    WWWWWW   W
W    RRRRRR   W
WV   T    T  VW
WWWWWWWWWWWWWWW
S
Made By: Mark Delfavero