WWWWWWWWWWWWWWW
W            PW
W WWWWWWWWWWWWW
W W     R     W
W         VW  W
WWWWWWWWWWWW  W
W  V  R    W  W
W        W    W
W  W W    R   W
WWWWWWWWWWWWWWW
S