WWWWWWWWWWWWWWW
W  R   B     TW
W W    W  W   W
WRWWW  W BN WWW
W     WW B    W
W  WWWWWWWVVW W
WWN    W      W
WWW    W WWWWWW
WP  B  B    BTW
WWWWWWWWWWWWWWW
S