WWWWWWWWWWWWWWW
W T  P        W
WWWWWWWWWWWWW W
W             W
W     N   WWWWW
W  WWWWWWWW T W
W  WWWW    B  W
W     W    W  W
WW W     B B  W
WWWWWWWWWWWWWWW
S