WWWWWWWWWWWWWWW
WVW    P    WVW
W     WWW     W
W W         W W
W W  WW WW  W W
W W         W W
W W WW   WW W W
W B    R    B W
W W   N N   W W
WWWWWWWWWWWWWWW
S