WWWWWWWWWWWWWWW
W             W
W P        TB W
WWWWW      WWTW
W   R      WWWW
W  W        WVW
W           W W
W      B      W
W  W   B    W W
WWWWWWWWWWWWWWW
S