WWWWWWWWWWWWWWW
W            PW
W WWWWWWWWWWWWW
W             W
W             W
W             W
W             W
W             W
W           T W
WWWWWWWWWWWWWWW
S